NO   ./rscs/textures/NO.xpm
SO   ./rscs/textures/SO.xpm
WE ./rscs/textures/WE.xpm
EA rscs/textures/EA.xpm

 F  220,100,0

C  225,30,0

   1111111111
   1000000001
   1000000001
   1000000001111
111100000S000001
1000000000000001
1000000000000001
1000011110000001
111111  11111111
