NO   ./path_to_the_north_texture
SO   ./path_to_the_south_texture
WE ./path_to_the_west_texture
EA ./path_to_the_east_texture

 F  220,100,0

C  225,30,0

111111111111111111111111111111
100000000000000000000000000001
100111110000001111111111110001
100100000000000000000000010001
100100000000000000011111110001
100100000000000000010000010001
1001000E0000000000010000010001
100100000000000000010000010001
100100000000000000010000010001
100100000000000000010000010001
100100000000011111110000001111
100100000000000000000000000001
100100000000000000000000011001
100111111111111111111111110001
100000000000000000000000000001
111111111111111111111111111111
